一	弌 一
上	丄 上
下	丅 下
世	丗 世
丘	丠 丘
乃	廼 乃
久	乆 久
乘	乗 乘
乾	亁 乾
事	亊 事
二	弍 二
亞	亜 亞
亡	兦 亡
享	亯 享
京	亰 京
仁	忈 仁
仙	僊 仙
仞	仭 仞
以	㠯 以
份	彬 份
佇	竚 佇
低	仾 低
佑	祐 佑
佞	侫 佞
併	倂 併
俎	爼 俎
俞	兪 俞
俟	竢 俟
信	伩 信
俯	頫 俯
俱	倶 俱
個	箇 個
倏	倐 倏
倘	儻 倘
值	値 值
偃	㫃 偃
假	仮 假
停	仃 停
健	徤 健
偷	偸 偷
僞	偽 僞
傘	繖 傘
備	偹 備
傳	伝 傳
傻	儍 傻
亂	釠 亂
僥	徺 僥
僩	僴 僩
僭	僣 僭
價	価 價
儉	倹 儉
光	灮 光
兒	児 兒
兔	兎 兔
全	㒰 全
兩	両 兩
其	亓 其
冉	冄 冉
冑	伷 冑
冒	冐 冒
冗	宂 冗
冢	塚 冢
冤	寃 冤
冪	羃 冪
冰	氷 冰
冽	洌 冽
凡	凣 凡
凳	櫈 凳
函	圅 函
刃	刄 刃
刈	苅 刈
刊	刋 刊
刨	鉋 刨
刷	㕞 刷
券	劵 券
剁	刴 剁
剃	鬀 剃
剋	尅 剋
剩	剰 剩
