兌	兑
梲	棁
涗	涚
稅	税
脫	脱
蛻	蜕
說	説
銳	鋭
悅	悦
挩	捝
敓	敚
彥	彦
顏	顔
閱	閲
產	産
絕	絶
爲	為
潙	溈
僞	偽
嬀	媯
蔿	蒍
囪	囱
媼	媪
慍	愠
搵	揾
氳	氲
溫	温
熅	煴
縕	緼
膃	腽
榲	榅
蒕	蒀
蘊	藴
轀	輼
醞	醖
鰮	鰛
臥	卧
戶	户
屆	届
虛	虚
噓	嘘
只	衹 只
只有	衹有 只有
只要	衹要 只要
線	綫
叄	叁
溼	濕
衆	眾
潨	潀
癡	痴
皁	皂
蔥	葱
衛	衞
踊	踴
鉢	缽
鉤	鈎
臺	台
教	敎
告	告
翻譯	繙譯 翻譯
